21X11
WWWWWWWWWWWWWWWWWWWWW
WCtttWtttttttttWttttW
WtWWtWtWWWWWWWtWtWWtW
WtWtttttttttttttttWtW
WtWtWWtWWWGWWWtWWtWtW
WttttttW B Z WttttttW
WtWtWWtWWWWWWWtWWtWtW
WtWtttt   J   ttttWtW
WtWWtWtWWWWWWWtWtWWtW
WttttWtttttttttWtttCW
WWWWWWWWWWWWWWWWWWWWW
8,5
5X1