27X31
WWWWWWWWWWWWWWWWWWWWWWWWWWW
WTTTTTTTTTTTTWTTTTTTTTTTTTW
WTWWWWTWWWWWTWTWWWWWTWWWWTW
WCWWWWTWWWWWTWTWWWWWTWWWWCW
WTWWWWTWWWWWTWTWWWWWTWWWWTW
WTTTTTTTTTTTTTTTTTTTTTTTTTW
WTWWWWTWWTWWWWWWWTWWTWWWWTW
WTWWWWTWWTWWWWWWWTWWTWWWWTW
WTTTTTTWWTTTTWTTTTWWTTTTTTW
WWWWWWTWWWWW W WWWWWTWWWWWW
     WTWWWWW W WWWWWTW     
     WTWW         WWTW     
     WTWW WWWGWWW WWTW     
WWWWWWTWW w     w WWTWWWWWW
      T   w     w   T      
WWWWWWTWW w     w WWTWWWWWW
     WTWW wwwwwww WWTW     
     WTWW         WWTW     
     WTWW WWWWWWW WWTW     
WWWWWWTWW WWWWWWW WWTWWWWWW
WTTTTTTTTTTTTWTTTTTTTTTTTTW
WTWWWWTWWWWWTWTWWWWWTWWWWTW
WTWWWWTWWWWWTWTWWWWWTWWWWTW
WCTTWWTTTTTTTJTTTTTTTWWTTCW
WWWTWWTWWTWWWWWWWTWWTWWTWWW
WWWTWWTWWTWWWWWWWTWWTWWTWWW
WTTTTTTWWTTTTWTTTTWWTTTTTTW
WTWWWWWWWWWWTWTWWWWWWWWWWTW
WTWWWWWWWWWWTWTWWWWWWWWWWTW
WTTTTTTTTTTTTTTTTTTTTTTTTTW
WWWWWWWWWWWWWWWWWWWWWWWWWWW
11,13
5X3
